1
24 30
42 110 69 12 25 276 213 213 245 212 212 276 277 122 79 419 578 74 68 43 36 45 69 9 578 321 512 482 128 578
577 36 45 37 53 212 276 213 213 245 212 212 244 26 578 4 13 37 629 982 535 538 539 540 535 535 630 512 513 482
483 611 612 677 21 212 212 276 213 213 245 244 87 58 256 808 806 807 567 787 786 570 571 572 787 786 567 578 320 481
483 643 644 709 128 23 88 212 244 213 213 22 578 125 54 840 778 839 567 784 785 386 358 387 785 785 567 5 419 417
480 578 257 225 320 578 161 27 276 213 122 419 161 23 124 142 272 128 567 784 719 784 385 785 719 784 567 78 11 546
513 629 982 535 662 367 661 535 630 23 87 56 119 55 276 52 265 578 567 784 783 754 785 785 783 754 567 39 41 514
5 567 913 719 913 947 719 913 567 11 256 21 212 245 244 90 192 160 567 784 785 785 785 785 785 785 567 43 448 450
77 567 945 885 64 945 885 948 599 43 578 59 276 213 213 122 578 128 661 535 535 536 784 661 535 535 662 578 545 546
45 629 982 535 535 662 945 946 532 203 82 179 178 179 178 179 83 140 106 107 132 207 139 106 44 44 107 4 13 5
419 567 913 719 913 915 719 945 567 230 114 273 273 273 273 273 115 272 578 132 241 238 169 320 256 419 578 79 106 100
578 567 945 885 948 946 885 948 567 170 80 273 273 273 273 273 81 302 197 264 515 514 578 225 192 321 288 578 451 514
578 661 535 662 945 946 661 535 662 11 112 210 210 210 210 210 113 165 271 237 576 629 982 536 367 368 629 982 630 512
5 1018 1010 1018 561 562 1018 1010 1018 578 53 242 243 242 243 242 218 196 241 169 289 599 913 914 946 946 567 913 567 578
110 101 44 107 321 160 106 107 578 55 276 213 213 213 277 24 168 235 578 578 192 530 946 946 719 945 567 945 567 14
107 577 578 161 320 142 133 225 225 125 212 87 213 277 122 128 225 629 982 535 535 630 945 946 885 948 599 945 567 578
449 544 419 578 224 578 271 143 57 212 20 257 29 212 20 192 578 567 913 719 913 661 535 662 945 946 914 946 567 544
448 576 808 806 807 138 231 224 125 124 225 578 93 26 224 546 514 567 945 885 948 915 914 915 946 946 719 945 567 576
576 160 840 778 839 198 171 53 212 212 54 55 124 578 225 288 419 629 982 535 535 662 945 719 945 946 885 948 567 5
257 12 578 164 209 264 578 125 22 21 84 86 213 54 142 209 137 599 913 915 915 914 946 885 948 946 946 946 567 37
578 36 69 9 234 169 57 20 160 808 806 807 123 245 52 230 199 530 946 946 946 946 946 946 629 662 946 661 662 578
288 577 106 38 13 11 29 52 578 840 778 839 21 213 90 168 235 531 946 629 982 662 945 946 567 977 560 978 979 419
448 417 450 70 103 578 61 213 54 8 172 128 578 29 122 578 289 567 945 567 64 913 946 946 567 110 11 106 107 256
515 481 161 36 7 9 93 213 20 70 14 544 514 93 245 56 578 661 535 535 535 535 535 535 662 45 14 544 578 544
481 289 419 578 76 71 23 276 56 79 419 448 482 23 213 22 12 1018 978 1018 1010 1010 1018 978 1018 578 448 417 514 576
