21
31 24
520 258 259 260 520 520 441 442 520 258 259 260 520 441 442 520 520 339 74 75 75 75 75 75
552 258 259 260 552 552 459 460 552 258 259 260 552 525 523 552 552 339 74 75 75 75 75 75
552 258 259 260 552 552 256 492 552 258 259 260 552 557 555 552 552 51 74 75 75 75 75 75
556 236 237 238 556 556 467 467 556 236 237 238 556 467 467 556 556 83 74 75 75 75 75 75
6 268 269 270 6 6 6 6 6 268 269 270 6 6 6 6 6 210 41 75 75 75 75 75
340 340 309 7 464 340 340 340 340 340 340 340 340 433 7 107 107 243 6 6 6 241 6 6
467 468 468 7 466 468 467 468 467 468 467 468 468 339 7 107 240 240 240 107 240 240 107 107
6 6 6 107 6 6 6 6 6 66 8 6 432 309 7 240 240 107 240 240 240 107 107 107
107 107 107 107 107 66 7 107 107 6 300 66 339 468 7 240 107 339 7 107 26 107 107 107
107 107 107 66 107 6 107 66 339 7 5 340 309 8 240 240 107 368 470 340 503 340 340 340
107 107 107 107 107 107 107 6 339 7 5 467 468 7 240 107 432 340 309 530 535 467 467 467
107 107 66 7 107 66 432 340 309 7 5 6 6 240 240 432 309 530 531 8 6 6 6 6
107 107 6 432 340 340 309 530 468 7 240 240 240 240 107 339 532 8 6 272 240 240 240 240
107 107 107 339 467 467 468 8 6 240 240 107 107 107 432 309 8 240 240 272 5 5 5 5
305 470 340 309 8 6 6 5 5 240 107 339 7 107 339 532 7 240 5 5 66 368 305 305
305 337 467 468 7 107 240 240 5 240 107 339 7 107 339 8 272 240 5 464 469 305 305 305
305 337 6 6 240 240 240 107 240 240 107 339 7 107 339 7 240 5 5 466 368 305 305 305
305 337 107 240 240 107 107 107 240 107 464 340 340 504 433 7 240 240 5 6 368 305 305 305
305 337 107 240 107 339 7 107 240 240 466 467 467 536 339 7 107 272 240 5 368 305 305 305
305 337 107 240 107 432 340 309 7 240 6 6 6 6 464 433 7 107 272 5 368 305 305 305
305 337 107 240 107 370 530 468 7 240 5 5 5 5 466 464 433 7 240 5 368 305 305 305
305 337 107 240 107 466 8 6 240 240 240 240 240 5 6 466 370 7 272 5 368 305 305 305
305 337 107 240 107 6 107 240 240 5 5 5 240 240 107 6 466 7 240 5 368 305 305 305
305 337 107 240 240 240 240 240 5 432 340 309 7 240 240 5 6 5 240 5 368 305 305 305
305 337 107 5 107 107 240 240 107 339 530 468 7 5 240 240 240 5 272 5 368 305 305 305
340 340 340 340 340 433 7 240 107 370 8 6 272 240 240 5 240 240 240 5 368 305 305 305
467 467 467 467 468 339 7 240 107 466 7 107 240 272 5 339 7 5 240 5 368 305 305 305
6 6 6 6 6 339 7 240 107 6 5 240 240 5 464 309 7 5 240 5 368 305 305 305
107 107 107 107 107 339 7 240 240 240 240 240 240 5 466 468 7 272 272 5 368 305 305 305
107 107 107 107 107 339 7 5 5 5 240 5 240 240 6 6 272 272 5 5 368 305 305 305
107 107 107 107 107 464 340 433 7 240 240 5 5 240 5 272 272 5 5 5 368 305 305 305
