21
34 29
18 18 18 18 18 18 18 180 135 313 314 138 53 54 55 56 57 135 313 314 138 170 18 18 18 18 18 18 18
18 18 135 136 137 138 18 180 167 345 346 170 85 86 87 88 89 167 345 346 170 170 18 135 136 137 138 18 18
18 18 167 177 241 170 18 180 167 345 346 170 85 86 87 88 89 167 345 346 170 170 18 167 177 241 170 18 18
18 18 199 200 201 202 18 180 167 345 346 170 117 86 87 88 89 167 345 346 170 170 18 199 200 201 202 18 18
18 18 231 232 233 234 18 180 167 409 410 170 117 86 87 88 89 167 409 410 170 170 18 231 232 233 234 18 18
18 18 263 264 265 266 135 84 167 441 442 170 85 86 87 88 89 167 441 442 170 90 138 263 264 265 266 18 18
18 18 295 296 297 298 180 116 199 200 201 202 117 118 119 120 121 199 200 201 202 122 170 295 296 297 298 18 18
18 18 327 328 329 330 180 115 244 199 200 148 149 150 151 152 153 154 201 202 166 115 170 327 328 329 330 18 18
18 18 18 135 165 165 84 145 6 244 199 180 181 182 183 184 185 186 202 166 8 144 90 165 165 138 18 18 18
18 18 18 180 8 6 6 5 79 6 244 212 51 214 215 216 51 218 166 8 79 5 6 6 6 170 18 18 18
18 18 18 180 7 5 5 5 111 7 6 244 83 246 247 248 83 166 8 5 111 7 107 5 5 170 18 18 18
18 18 18 167 7 5 79 5 6 5 5 6 115 278 279 280 115 8 5 5 6 5 79 107 107 170 18 18 18
18 18 18 199 148 7 111 7 5 5 5 5 144 6 6 6 144 271 5 5 5 5 111 7 154 202 18 18 18
18 18 18 18 167 7 6 5 5 5 5 5 5 5 5 5 5 5 5 5 5 5 6 5 170 18 18 18 18
18 18 18 18 167 7 5 5 5 5 5 5 5 5 5 5 5 5 5 5 5 5 5 5 170 18 18 18 18
18 18 18 135 84 7 5 5 5 5 5 5 135 138 7 135 138 7 5 5 5 5 5 5 90 138 18 18 18
18 18 18 180 116 7 79 5 5 5 5 135 136 166 3 160 137 138 7 5 5 5 79 5 122 170 18 18 18
18 18 18 180 115 7 111 7 5 5 5 167 262 391 13 198 256 170 7 5 5 5 111 7 115 170 18 18 18
18 18 18 180 145 39 6 5 5 5 5 167 177 241 273 241 241 170 7 5 5 5 6 5 144 170 18 18 18
18 18 135 84 7 5 5 135 136 7 5 199 200 176 240 240 201 202 7 5 137 138 7 5 5 90 138 18 18
18 18 180 116 7 5 5 167 391 74 76 101 167 176 240 240 170 391 74 76 101 170 7 5 5 122 170 18 18
18 18 180 115 7 5 5 167 8 6 6 6 199 200 51 201 202 8 6 6 6 170 7 5 5 115 170 18 18
18 18 180 145 39 5 5 167 7 5 5 5 101 232 83 233 391 7 5 5 5 170 7 5 5 144 170 18 18
18 18 180 7 5 5 5 199 200 7 5 5 6 101 101 101 8 5 5 5 201 202 7 5 5 5 170 18 18
18 18 180 7 5 5 5 101 167 7 5 5 5 6 6 6 5 5 5 5 170 391 7 5 5 5 170 18 18
18 18 180 7 5 5 5 6 199 200 7 5 5 5 5 5 5 5 5 201 202 8 5 5 5 5 170 18 18
18 18 180 7 5 5 5 5 101 167 7 5 5 5 5 5 5 5 5 170 391 7 5 5 5 5 170 18 18
18 18 180 7 79 5 5 5 6 199 200 7 5 5 5 5 5 5 201 202 8 5 5 5 79 5 170 18 18
18 18 180 7 111 79 5 5 5 101 167 7 5 5 5 5 5 5 170 391 7 5 5 79 111 7 170 18 18
18 18 180 7 6 111 7 5 5 6 167 7 5 5 5 5 5 5 170 8 5 5 5 111 8 5 170 18 18
18 18 180 7 5 6 5 5 5 5 167 7 5 5 5 5 5 5 170 7 5 5 5 6 5 5 170 18 18
18 18 244 162 99 164 165 161 161 161 51 7 5 5 5 5 5 5 51 161 161 161 161 162 99 164 166 18 18
18 18 521 194 195 196 521 525 523 521 83 74 75 75 75 75 75 76 83 521 525 523 521 194 195 196 521 18 18
18 18 553 226 104 105 553 557 555 553 115 74 75 75 75 75 75 76 115 553 557 555 553 226 104 105 553 18 18
