21
34 29
18 18 18 18 18 18 18 180 208 240 135 180 149 150 151 152 153 170 138 208 240 170 18 18 18 18 18 18 18
18 18 135 136 137 138 18 180 208 240 199 148 224 230 183 224 230 154 202 208 240 170 18 135 136 137 138 18 18
18 18 167 177 241 170 18 180 176 272 241 212 256 262 215 256 262 218 177 240 272 170 18 167 177 241 170 18 18
18 18 199 200 201 202 18 180 208 240 240 244 51 246 247 248 51 166 176 240 240 170 18 199 200 201 202 18 18
18 18 231 232 233 234 18 180 208 240 240 241 83 244 161 166 83 177 240 240 272 170 18 231 232 233 234 18 18
18 18 263 264 265 266 135 84 176 240 17 240 115 177 241 241 115 208 17 240 240 90 138 263 264 265 266 18 18
18 18 295 296 297 298 180 116 199 176 240 240 146 209 272 240 146 209 240 240 202 122 170 295 296 297 298 18 18
18 18 327 328 329 330 180 115 244 199 176 240 240 240 240 240 240 240 240 202 166 115 170 327 328 329 330 18 18
18 18 18 135 165 165 84 145 6 244 199 176 240 240 240 272 240 240 202 166 8 144 90 165 165 138 18 18 18
18 18 18 180 8 6 6 5 79 6 244 212 51 176 17 240 51 218 166 8 79 5 6 6 6 170 18 18 18
18 18 18 180 7 5 5 5 111 7 6 244 83 176 240 240 83 166 8 5 111 7 107 5 5 170 18 18 18
18 18 18 167 7 5 79 5 6 5 5 6 115 74 75 76 115 8 5 5 6 5 79 107 107 170 18 18 18
18 18 18 199 148 7 111 7 5 5 5 5 144 6 6 6 144 271 5 5 5 5 111 7 154 202 18 18 18
18 18 18 18 167 7 6 5 5 5 5 5 5 5 5 5 5 5 5 5 5 5 6 5 170 18 18 18 18
18 18 18 18 167 7 5 5 5 5 5 5 5 5 5 5 5 5 5 5 5 5 5 5 170 18 18 18 18
18 18 18 135 84 7 5 5 5 5 5 5 135 138 7 135 138 7 5 5 5 5 5 5 90 138 18 18 18
18 18 18 180 116 7 79 5 5 5 5 135 136 166 7 160 137 138 7 5 5 5 79 5 122 170 18 18 18
18 18 18 180 115 7 111 7 5 5 5 167 262 391 13 198 256 170 7 5 5 5 111 7 115 170 18 18 18
18 18 18 180 145 39 6 5 5 5 5 167 177 241 273 241 241 170 7 5 5 5 6 5 144 170 18 18 18
18 18 135 84 7 5 5 135 136 7 5 199 200 176 240 240 201 202 7 5 137 138 7 5 5 90 138 18 18
18 18 180 116 7 5 5 167 391 74 76 101 167 176 240 240 170 391 74 76 101 170 7 5 5 122 170 18 18
18 18 180 115 7 5 5 167 8 6 6 6 199 200 51 201 202 8 6 6 6 170 7 5 5 115 170 18 18
18 18 180 145 39 5 5 167 7 5 5 5 101 232 83 233 391 7 5 5 5 170 7 5 5 144 170 18 18
18 18 180 7 5 5 5 199 200 7 5 5 6 101 101 101 8 5 5 5 201 202 7 5 5 5 170 18 18
18 18 180 7 5 5 5 101 167 7 5 5 5 6 6 6 5 5 5 5 170 391 7 5 5 5 170 18 18
18 18 180 7 5 5 5 6 199 200 7 5 5 5 5 5 5 5 5 201 202 8 5 5 5 5 170 18 18
18 18 180 7 5 5 5 5 101 167 7 5 5 5 5 5 5 5 5 170 391 7 5 5 5 5 170 18 18
18 18 180 7 79 5 5 5 6 199 200 7 5 5 5 5 5 5 201 202 8 5 5 5 79 5 170 18 18
18 18 180 7 111 79 5 5 5 101 167 7 5 5 5 5 5 5 170 391 7 5 5 79 111 7 170 18 18
18 18 180 7 6 111 7 5 5 6 167 7 5 5 5 5 5 5 170 8 5 5 5 111 8 5 170 18 18
18 18 180 7 5 6 5 5 5 5 167 7 5 5 5 5 5 5 170 7 5 5 5 6 5 5 170 18 18
18 18 244 162 99 164 165 161 161 161 51 7 5 5 5 5 5 5 51 161 161 161 161 162 99 164 166 18 18
18 18 521 194 195 196 521 525 523 521 83 74 75 75 75 75 75 76 83 521 525 523 521 194 195 196 521 18 18
18 18 553 226 104 105 553 557 555 553 115 74 75 75 75 75 75 76 115 553 557 555 553 226 104 105 553 18 18
