1
34 34
419 419 419 419 419 419 419 419 419 419 419 419 419 419 419 419 419 419 128 419 419 128 128 276 276 276 276 276 276 276 276 276 276 276
419 419 419 419 128 128 419 128 128 128 419 419 128 419 419 419 419 419 419 128 419 419 128 276 276 276 276 276 276 276 276 276 276 276
419 419 128 128 128 128 128 128 128 128 419 128 128 128 128 419 419 419 419 419 419 128 128 128 276 276 276 276 276 276 276 276 276 276
419 128 128 672 673 674 128 675 676 677 128 678 679 680 128 128 419 419 419 419 419 419 419 128 128 629 535 535 535 630 276 276 276 276
419 128 128 704 705 706 128 707 708 709 128 710 711 712 128 419 128 128 128 128 419 128 128 128 128 567 785 785 785 661 630 276 276 276
419 419 128 128 128 128 128 128 128 128 128 128 128 128 419 419 128 128 629 535 535 535 535 535 535 535 630 785 65 785 600 276 276 276
419 419 419 419 128 128 128 128 128 419 419 128 419 419 128 128 629 535 567 354 361 538 539 540 361 355 600 785 785 785 661 630 276 276
419 419 128 128 128 128 128 419 419 419 419 419 419 128 128 629 662 946 567 362 363 570 571 572 363 394 600 785 785 785 785 661 0 0
128 128 128 928 929 930 128 128 419 419 419 128 128 128 629 662 946 946 567 386 393 602 603 604 393 387 600 785 785 785 785 785 0 0
302 128 128 960 961 962 128 128 128 128 128 128 629 535 662 946 65 946 661 535 535 535 385 535 535 535 662 785 785 785 785 785 0 0
302 302 128 128 128 128 128 864 865 866 128 629 662 946 946 946 946 946 946 946 785 785 785 785 785 785 785 785 785 785 785 785 0 0
302 302 302 128 128 128 128 896 996 898 128 567 946 946 946 946 946 946 946 785 785 785 785 785 785 785 785 785 785 785 785 785 0 0
302 302 302 302 302 128 128 128 128 128 128 567 946 946 946 946 946 946 946 946 785 785 785 785 785 785 785 785 785 785 785 785 0 0
302 302 302 302 302 302 128 128 128 128 128 567 946 946 946 946 946 946 946 946 946 785 785 785 785 785 785 785 785 785 785 785 0 0
128 302 302 302 302 302 302 302 302 128 128 567 946 946 946 946 946 946 946 946 946 946 946 785 785 785 785 785 785 785 785 785 0 0
128 128 302 302 302 302 302 302 302 302 302 661 535 630 946 946 946 946 946 946 946 946 946 785 785 785 785 785 785 785 785 785 0 0
128 128 302 302 302 302 302 302 302 302 302 302 302 434 946 946 946 946 946 946 946 946 946 785 785 785 785 785 785 785 535 535 0 0
419 128 302 302 302 302 302 302 302 302 302 302 302 946 946 946 946 946 946 946 946 946 946 946 946 946 535 535 535 535 276 276 276 276
419 419 302 302 302 302 302 302 302 302 302 302 302 567 946 946 946 946 946 946 946 946 946 946 946 535 276 276 276 276 276 276 276 276
419 419 302 302 302 302 302 302 128 128 128 128 128 661 535 535 535 535 535 535 535 535 535 535 535 276 276 276 276 276 276 276 276 276
419 128 302 302 302 302 128 128 128 128 128 128 276 276 276 276 276 276 276 276 276 276 276 276 276 276 276 276 128 128 128 128 128 276
419 128 302 302 302 128 128 128 276 276 276 276 276 276 276 276 276 276 276 276 276 276 276 276 276 276 276 128 128 128 128 419 128 276
128 302 302 302 302 302 128 128 276 276 276 276 276 276 276 276 276 276 276 276 276 276 276 276 276 128 128 419 419 419 419 128 419 128
128 302 302 302 302 302 128 128 128 128 128 128 128 82 178 178 178 178 178 179 178 178 179 128 128 128 128 419 419 419 419 419 128 128
128 302 302 302 302 302 302 302 302 302 302 302 302 80 273 274 274 274 274 275 274 274 275 128 128 419 419 419 419 419 419 419 419 128
419 128 302 302 302 302 302 302 302 302 302 302 302 80 305 306 306 306 306 307 306 306 307 128 128 419 419 419 419 419 419 419 419 419
419 128 128 302 302 302 302 302 302 302 302 302 302 80 337 306 306 306 306 339 306 306 339 128 419 419 419 419 128 419 419 419 419 419
419 419 128 128 302 302 302 302 302 302 302 302 302 80 305 306 306 306 306 307 306 306 307 128 419 419 419 419 419 419 419 419 419 419
419 419 419 128 128 128 302 302 302 302 302 302 302 80 337 338 338 338 338 339 338 338 339 128 419 419 128 419 419 419 419 419 419 419
419 419 419 128 128 128 128 128 128 128 128 128 128 112 210 210 210 210 210 211 210 210 211 128 128 419 419 419 419 419 419 419 419 419
419 419 419 419 128 128 128 128 419 419 419 419 128 128 276 242 242 242 242 243 242 242 243 128 128 128 419 419 419 419 128 419 419 128
419 419 128 419 419 419 419 419 419 419 128 128 128 276 276 276 276 276 276 276 276 276 276 276 128 128 128 419 419 419 128 419 419 419
419 419 419 128 128 128 128 128 419 419 128 128 128 276 276 276 276 276 276 276 276 276 276 276 276 128 128 419 419 419 419 419 419 419
419 419 419 419 419 419 419 419 128 128 276 276 276 276 276 276 276 276 276 276 276 276 276 276 276 128 128 128 419 419 419 419 419 419
