9
29 44
161 899 900 901 128 896 897 898 521 165 707 708 709 419 57 212 20 419 419 419 545 419 578 568 77 161 578 160 128 160 128 161 128 521 484 522 416 128 128 161 128 160 128 160
457 457 522 128 161 426 489 489 586 578 142 586 419 419 21 122 128 160 419 578 629 535 535 662 77 578 128 128 161 128 160 161 553 489 489 489 554 128 161 128 128 578 161 128
867 868 747 678 615 680 419 808 806 811 744 936 806 807 419 221 52 128 419 416 568 730 725 858 77 161 416 578 160 128 128 553 522 578 578 419 521 554 128 419 578 128 160 419
899 900 779 710 647 712 138 840 838 843 997 968 838 839 133 25 124 140 128 578 568 110 110 110 37 128 593 398 535 535 535 593 456 128 419 416 521 452 593 398 535 535 535 535
161 172 578 138 516 554 170 516 516 516 516 452 516 457 516 457 83 516 554 128 568 110 110 107 578 161 568 856 724 725 568 894 460 554 419 419 521 516 894 730 823 825 823 568
132 457 197 134 518 516 457 452 484 516 484 516 518 489 452 489 115 489 516 133 568 110 103 128 161 416 568 787 722 786 564 532 452 522 128 578 521 452 530 915 914 914 914 568
484 489 489 302 302 489 239 489 516 518 489 516 165 578 295 128 125 52 271 516 568 77 160 578 419 160 568 720 785 721 596 628 516 489 520 488 489 489 531 947 719 945 947 568
231 578 128 234 235 128 578 578 164 586 128 585 143 416 416 578 27 90 230 516 629 535 535 535 535 429 593 784 719 784 593 398 535 630 419 578 128 416 593 945 883 948 946 568
169 128 419 578 416 578 864 865 805 806 807 128 419 128 419 128 59 220 236 516 568 856 724 725 860 568 625 720 783 755 625 730 725 593 398 535 535 535 535 593 945 946 947 629
133 419 672 609 674 419 896 897 837 838 839 140 128 578 160 57 89 124 198 302 558 39 44 44 44 568 656 754 721 785 656 786 722 568 980 538 539 540 980 568 945 946 947 568
522 160 704 641 706 202 196 522 416 521 457 516 554 128 55 24 132 83 302 167 590 109 553 133 419 568 784 721 785 721 785 721 785 599 819 570 571 572 819 599 945 719 946 568
452 555 457 516 457 516 516 516 457 516 518 516 489 488 19 132 229 115 228 171 568 109 164 272 416 568 433 784 721 537 630 784 721 568 886 362 363 394 849 568 945 883 947 629
452 229 228 302 165 172 743 744 745 744 747 165 578 53 24 265 128 29 54 160 568 71 266 267 578 568 784 721 785 65 568 720 785 500 886 386 358 387 849 500 945 946 946 568
522 128 419 271 143 578 775 997 777 776 779 116 59 24 202 203 128 93 124 329 537 692 11 265 128 593 528 785 721 528 568 784 721 500 886 849 385 849 849 500 945 946 946 500
165 128 160 295 128 202 196 302 302 207 133 125 124 808 806 807 139 123 24 519 857 1005 43 419 128 894 398 501 501 429 662 720 785 568 528 849 849 849 528 568 945 946 947 568
578 160 160 161 132 316 247 246 316 247 246 314 220 840 838 839 171 21 58 330 44 44 553 197 206 530 914 915 914 568 723 785 721 537 535 535 557 535 535 461 945 946 946 568
161 416 208 207 316 247 212 312 247 212 212 212 214 334 267 128 193 59 124 164 488 488 489 516 489 531 946 947 946 500 784 721 785 722 786 722 786 722 786 500 945 719 946 500
132 302 316 247 313 212 212 212 212 212 244 213 281 52 204 209 57 212 22 416 629 692 11 265 160 593 945 719 945 500 528 785 721 785 721 785 721 785 721 500 945 883 947 568
316 316 247 212 212 212 245 245 212 213 213 213 245 212 281 313 212 212 56 578 568 1005 43 416 160 568 945 883 948 537 535 535 535 535 501 501 535 501 501 662 945 946 947 537
316 247 212 212 212 276 277 212 244 213 213 213 213 212 212 244 212 212 28 128 568 77 578 160 419 568 945 946 947 915 914 915 914 915 914 915 914 915 914 915 947 946 946 914
247 212 212 212 212 212 212 244 213 213 277 212 213 245 245 212 277 213 92 419 537 535 535 692 578 692 400 945 946 947 946 947 946 947 946 947 719 945 946 719 945 946 946 946
212 212 212 212 244 213 213 245 213 213 212 212 212 213 213 245 244 213 245 54 857 724 725 1005 43 1005 692 398 535 535 535 535 535 535 593 945 883 948 947 883 948 528 946 946
212 212 212 244 276 213 213 213 213 277 20 23 283 277 213 244 213 213 213 212 52 118 55 248 196 133 1005 856 724 725 860 724 725 860 894 945 946 629 535 535 557 535 535 429
212 244 213 213 213 213 213 213 213 220 132 207 165 25 213 213 213 213 213 213 245 212 212 312 247 313 56 44 44 44 44 44 44 44 530 946 947 568 723 786 722 786 722 568
212 245 213 213 213 213 276 213 277 22 271 165 119 55 213 213 213 213 213 213 213 213 213 245 212 212 212 54 118 419 128 578 132 457 531 947 946 568 784 721 785 721 785 568
244 213 213 213 213 213 245 213 276 56 265 53 212 244 213 213 213 213 213 213 213 213 213 213 213 245 212 212 212 52 140 142 516 165 593 945 947 568 720 65 720 65 720 568
213 213 213 213 213 213 213 213 212 124 59 212 212 213 213 213 213 213 213 213 213 213 213 213 213 245 276 212 212 212 246 133 265 578 568 945 946 568 784 65 784 722 785 568
213 213 213 213 213 213 213 213 245 212 212 212 213 213 213 213 213 213 213 213 213 213 213 213 213 213 213 245 212 212 312 272 325 128 568 945 946 568 720 786 721 785 721 568
213 213 213 213 213 213 89 213 213 276 244 213 213 213 213 213 213 213 213 213 213 213 213 213 213 213 277 212 212 212 280 316 165 419 568 945 947 537 535 535 535 535 535 630