16
34 32
66 463 417 618 460 461 592 197 705 99 66 66 198 67 66 99 198 771 770 801 198 224 800 770 801 596 598 66 197 229 198 98
591 524 524 545 461 592 67 66 197 674 147 198 67 771 803 66 677 197 198 66 66 197 229 198 197 601 98 99 99 98 596 538
524 616 583 746 592 229 197 66 67 198 672 803 769 177 197 740 192 192 66 198 66 192 224 66 35 632 66 197 66 631 629 198
658 494 592 685 66 198 66 955 956 957 66 197 955 956 957 66 197 140 141 955 956 959 198 66 229 628 571 597 229 601 8 229
64 684 197 66 66 66 99 1019 1020 862 956 925 989 988 988 956 927 102 81 987 989 991 70 82 79 45 198 664 596 598 197 224
98 99 742 98 197 98 98 229 66 1019 1022 66 1019 1020 862 988 988 957 102 45 98 44 111 6 103 198 192 628 635 597 631 539
561 655 545 561 66 229 66 292 295 99 198 229 98 99 893 989 862 894 956 1022 66 229 197 113 45 98 197 192 66 599 605 197
613 524 616 528 685 198 292 258 259 225 295 198 197 98 229 66 986 988 988 958 98 198 44 103 229 66 66 224 192 197 628 538
460 646 717 18 774 774 774 774 774 774 774 774 774 901 948 907 893 862 990 66 907 66 900 810 774 774 774 774 774 774 774 774
460 615 577 50 51 981 981 981 981 981 981 981 981 776 774 937 948 987 988 957 937 779 777 918 981 981 981 981 981 981 981 981
592 463 523 617 496 64 65 64 352 64 65 64 65 949 981 970 1012 954 988 991 970 918 950 1011 64 65 64 65 64 65 352 64
687 463 416 717 528 685 292 229 198 140 70 71 141 64 65 1001 955 988 861 1021 1001 64 65 197 192 224 197 66 192 66 98 66
591 417 618 461 428 593 352 224 98 142 6 6 111 45 198 987 988 988 990 197 66 98 66 66 66 192 224 198 229 224 229 198
524 616 492 460 592 198 229 66 66 102 6 111 45 66 955 956 988 988 988 927 66 98 98 229 66 66 229 66 66 197 229 98
417 461 494 560 684 653 66 197 98 66 46 66 98 954 988 988 988 861 862 988 956 957 197 198 197 66 66 197 644 641 685 99
618 907 774 774 774 907 83 66 707 98 66 229 66 953 988 988 861 1022 893 989 988 988 959 66 98 229 197 98 66 192 645 685
528 806 825 826 827 806 115 740 177 197 98 99 98 985 988 861 1022 78 14 1019 862 988 894 927 66 98 98 66 197 224 99 643
496 806 976 793 794 806 980 197 99 66 198 66 66 1019 1020 1021 70 6 143 66 893 989 988 988 957 66 66 198 66 66 197 98
592 905 1008 1009 1010 905 980 198 229 224 66 98 66 66 98 66 113 6 6 71 66 987 862 861 989 927 66 98 198 197 229 198
771 937 965 965 966 937 1012 99 292 907 779 774 774 774 774 774 808 809 810 774 774 774 774 907 883 985 959 66 197 292 197 292
198 1001 64 65 64 1001 674 66 352 806 870 871 871 871 871 871 871 806 870 871 848 871 871 806 979 893 1021 672 802 352 98 108
99 197 71 955 957 66 705 229 70 806 974 911 922 911 922 911 922 806 974 944 880 946 922 806 979 14 70 45 176 768 147 197
71 44 103 987 990 198 176 66 142 806 943 939 943 1007 939 942 1007 806 906 976 977 978 906 806 979 102 6 82 77 70 740 177
46 67 197 1019 862 956 958 70 6 806 942 971 975 1007 971 975 1006 776 774 774 727 774 774 901 979 44 111 103 197 113 71 66
927 66 66 99 955 988 927 102 6 806 943 1006 900 875 943 776 774 760 871 871 759 871 871 806 979 955 956 957 70 6 6 79
989 925 956 956 988 988 988 958 113 806 942 1007 806 974 1006 911 922 911 922 911 922 911 922 806 979 893 988 991 113 6 103 102
198 987 862 988 988 861 991 229 102 806 943 1006 806 942 1007 1006 1007 1007 1006 1006 1006 1006 1006 806 979 987 988 990 172 104 197 99
752 745 1019 862 988 1022 66 70 45 806 942 1007 806 943 906 900 810 774 774 774 774 774 774 907 979 955 988 988 927 136 45 197
616 561 685 987 1022 70 79 103 66 806 779 934 779 774 777 905 870 871 871 871 871 871 871 856 979 953 988 988 990 142 79 45
717 429 561 685 229 102 6 109 70 806 974 911 922 911 922 937 870 871 871 871 871 871 871 970 1011 953 988 861 1022 142 103 197
544 429 496 684 653 70 169 198 142 806 943 939 942 1007 1007 860 64 65 64 65 64 65 64 1001 955 988 861 1022 66 102 197 193
422 429 429 561 76 6 137 70 6 806 942 971 975 939 942 892 957 66 955 958 66 954 956 957 986 988 1022 198 192 197 198 654
519 576 429 528 197 102 103 198 46 806 942 1007 1007 971 975 892 988 956 925 958 98 739 1019 1020 1019 989 958 197 197 229 591 498
555 556 545 465 653 229 197 292 653 806 942 939 1007 1007 1007 905 1020 1021 198 66 640 98 643 66 140 14 99 66 192 684 463 617